=login.jsp
login-page=login.jsp
login=LoginServlet
invalid-page=invalid.html
admin-page=admin-page.jsp
load-admin-page=LoadAdminPageServlet
student-page=student-page.jsp
load-student-page=LoadStudentPageServlet
logout=LogoutServlet
sign-up=SignUpServlet
load-create-question-page=LoadCreateQuestionPage
create-question-page=create-question.jsp
create-question=CreateQuestionServlet
search-question=SearchQuestionServlet
update-status-question=UpdateStatusQuestionServlet
load-update-question-page=LoadUpdateQuestionPageServlet
update-question=UpdateQuestionServlet
update-question-page=update-question.jsp
setup-quiz-page=setup-quiz.jsp
load-setup-quiz-page=LoadSetupQuizPageServlet
setup-quiz=SetupQuizServlet
attempt-quiz=AttemptQuizServlet
quiz-page=quiz-page.jsp
resume-quiz=AttemptQuizServlet
submit-quiz=SubmitQuizServlet
submit-error-page=submit-errror-page.jsp
quiz-result-page=quiz-result-page.jsp
load-quiz-result-page-servlet=LoadQuizResultPageSerlvet
quiz-history=quiz-history.jsp
search-quiz=SearchQuizServlet
load-quiz-history-servlet=LoadQuizHistoryServlet